NO ./textures/north.xpm
SO ./textures/south.xpm
WE ./textures/west.xpm
EA ./textures/east.xpm

F 100,100,100
C 135,206,235

110111
100101
101001
1100N1
111111
