NO ./textures/bluestone.xpm
SO ./textures/redbrick.xpm
EA ./textures/greystone.xpm
WE ./textures/mossy.xpm
F 112,112,112
C 48,48,48

111111111111111111111111111111
100000000000000000000000000001
100000000000000000000000000001
100000000011100000001111111101
100000001110000000111000011101
100000101001100000000001110001
100011100011000000001110000001
101111111111110001110000000001
100000001100000111000000000001
101000011000011111111111000001
100000000000000000000000000001
111000000000000000000000000001
  1111111111000000111111111111
 11111111111000000111111111111
 10000000000001100000000000001
 10000000000001100000000100101
 10111111111000000000000100001
110111111111100000000000100001
100000000000110100000000111101
10N000000000110001000000000001
100000000000110000000000110101
100011011000110100000000010001
100011011000110000000000001101
100000000000110000000000000101
100011011000110000000000000001
100011011000110011101011111111
10000000000011000110001
100010101000110011110111111111
10011111110011001 100000000001
1111     11111111 111111111111
