NO ./textures/bluestone.xpm
SO ./textures/redbrick.xpm
EA ./textures/greystone.xpm
WE ./textures/mossy.xpm
F 112,112,112
C 48,48,48

1111111111111111
1000000000000001           1
1000000000000001           1
1000000001110001    111111111
1000000111000001111110000001
1000001100011101000000011111
100011100011100001011111
10111111111111000111
100000001110000001
1110000111000000011111111111
1010000000000000000000001
1110000000000000000000001
  1111111111000000111111111111
 11111111111000000111111111111
 10000000000001100000000000001
 10000000000001100000000100101
 10111111111000000000000100001
110111111111100000000000100001
100000000000110100000000111101
100000000000110001000000000001
100000000000110000000000111101
100011011000110100000000010101
100N11111000110000000000001101
100001010000110000000000000101
100011111000110000000000000001
100011011000110011101011111111
10000000000011000010001
100010101000110010110111111111
100111111100110010100000000001
100111111100110010100000000001
100111111100110010100000000001
100111111100110010100000000001
100111111100110010100000000001
100111111100110010100000000001
100111111100110010000000000001
11111    111111111111111111111
