NO ./textures/bluestone.xpm
SO ./textures/redbrick.xpm
EA ./textures/greystone.xpm
WE ./textures/mossy.xpm
F 112,112,112
C 48,48,48

1111111111111
1000000000001           1
1000000000001           1
1000001110001   111111111
1000011000001111110000001
1000000011101000000011111
100010011100001011111
10111111111000111
100001110000001
1010011000000011111111111
1000000000000000000001
1110000000000000000001
  1100000000000111111111111
 11100000000000111111111111
 10000000001100000000000001
 10100000001100000000100101
 10111111000000000000100001
110111111100000000000100001
100000000110100000000111101
100000000110001000000000001
100011000110000000000000001
10N011000110011101011111111
10000000011000010001
100011000110010110111111111
100111100110010100000000001
100100100110010100000000001
100100100110010100000000001
100100100110010100000000001
100000100110010100000000001
100100100110010100000000001
100111100110010000000000001
1111  111111111111111111111
