NO ./textures/bluestone.xpm
SO ./textures/redbrick.xpm
EA ./textures/greystone.xpm
WE ./textures/mossy.xpm
F 112,112,112
C 48,48,48

111111111111111
100000000000001
100000000000001
100000000000001
111111000111111
100000000000001
100N00000000001
100000000000001
111111000111111
100000000000001
100000000000001
100000000000001
111111111111111
