FLOOR ./textures/wood.xpm
CEILING ./textures/colorstone.xpm
WALL ./textures/redbrick.xpm
DOOR ./textures/door.xpm
BARREL ./textures/barrel.xpm
PILLAR ./textures/pillar.xpm
LIGHT ./textures/greenlight.xpm
TREE1 ./textures/tree_0.xpm
TREE2 ./textures/tree_1.xpm
TREE3 ./textures/tree_2.xpm
TREE4 ./textures/tree_3.xpm
TREE5 ./textures/tree_4.xpm

SP 2 2 BARREL
SP 5.5 5.5 TREE


111111111111111111111111111111
100000000000000000000000000001
100000000000000000000000000001
100000000011100000001111111101
100000001110000000111000011101
100000121001100000000001110001
100011100011000000001110000001
101111111111110001110000000001
100000001100000111000000000001
121000011000011111111111000001
102000000000000000000000000001
111000000000000000000000000001
  1111111111000000111111111111
 11111111111000000111111111111
 10000000000001100000000000001
 10000000000001100000000100101
 10111111111000000000000100001
112111111111100000000000100001
100000000000110100000000111101
10N000000000110001000000000001
100000000000110000000000112101
100011011000112100000000010201
100011211000110000000000001101
100002020000110000000000000101
100011211000110000000000000001
100011011000110011121211111111
10000000000011000110001
100010101000110011112111111111
10011111110011001 100000000001
1111     11111111 111111111111
