FLOOR ./textures/greystone.xpm
CEILING ./textures/wood.xpm
WALL ./textures/redbrick.xpm
DOOR ./textures/door.xpm
BARREL ./textures/barrel.xpm
PILLAR ./textures/pillar.xpm
LIGHT ./textures/greenlight.xpm
TREE1 ./textures/tree_0.xpm
TREE2 ./textures/tree_1.xpm
TREE3 ./textures/tree_2.xpm
TREE4 ./textures/tree_3.xpm
TREE5 ./textures/tree_4.xpm

1111111111111111
1000000000000001           1
1000000000000001           1
1000000001110001    111111111
1000000111000001111110000001
1000001100011101000000011111
100011100011100001011111
10111111111111000111
100000001110000001
1210000111000000011111111111
1020000000000000000000001
1110000000000000000000001
  1111111111000000111111111111
 11111121111000000111111111111
 10000000000001100000000000001
 10000000000001100000000100101
 10111111111000000000000100001
112111111111100000000000100001
100000000000110100000000111101
100000000000110001000000000001
100000000000110000000000112101
100011011000110100000000010201
10W011211000110000000000001101
100002020000110000000000000101
100011211000110000000000000001
100011011000110011121211111111
10000000000011002010001
100010101000110010112111111111
100111111100110010100000000001
100100000100110010100000000001
100100000100110010100000000001
100100000100110010100000000001
100100000100110010100000000001
100200000100110010100000000001
100100000100110010200000000001
111111111111111111111111111111
