FLOOR ./textures/wood.xpm
CEILING ./textures/colorstone.xpm
WALL ./textures/redbrick.xpm
DOOR ./textures/door.xpm
BARREL ./textures/barrel.xpm
PILLAR ./textures/pillar.xpm
LIGHT ./textures/greenlight.xpm
TREE1 ./textures/eagle.xpm
TREE2 ./textures/bluestone.xpm
TREE3 ./textures/purplestone.xpm
TREE4 ./textures/greystone.xpm
TREE5 ./textures/mossy.xpm

11111111111111111111111111111
10000000001100000000000000001
10110000011100000000000000001
10010000000000000000000000001
10110000011100000000000000001
10000000001100000111011111001
11110111111111011100000010001
11110111111111011101010010001
11000000110101011100000010001
10000000000000001100000010001
10000000000000001101010010001
11000001110101011111011110001
11110111111110101010111100001
11111111111111111111111111111
10000000000000000000000000001
10000000000000000000000000001
10000000000000N00000000000001
10000000000000000000000000001
10000000000000000000000000001
11111111111111111111111111111
