FLOOR ./textures/wood.xpm
CEILING ./textures/colorstone.xpm
WALL ./textures/redbrick.xpm
DOOR ./textures/door.xpm
BARREL ./textures/barrel.xpm
PILLAR ./textures/pillar.xpm
LIGHT ./textures/greenlight.xpm
TREE1 ./textures/tree_0.xpm
TREE2 ./textures/tree_1.xpm
TREE3 ./textures/tree_2.xpm
TREE4 ./textures/tree_3.xpm
TREE5 ./textures/tree_4.xpm

F 220,100,0
C 225,30,0

        1111111111111111111111111
        1000000000110000000000001
        1011000001110000P00000001
        10010000000000000Q0000001
111111111011000001110000000000001
100000000011000001110111111111111
11110111111111011100000010001
11110111111111011101010010001
11000000110101011100000010001
10000000000000001100000010L01
10000000000000001101010010001
11000001110101011111011110N0111
11110111 1110101 101111010001
11111111 1111111 111111111111
