FLOOR ./textures/wood.xpm
CEILING ./textures/colorstone.xpm
WALL ./textures/redbrick.xpm
DOOR ./textures/door.xpm
BARREL ./textures/barrel.xpm
PILLAR ./textures/pillar.xpm
LIGHT ./textures/greenlight.xpm
TREE1 ./textures/tree_0.xpm
TREE2 ./textures/tree_1.xpm
TREE3 ./textures/tree_2.xpm
TREE4 ./textures/tree_3.xpm
TREE5 ./textures/tree_4.xpm

11111111111111111111111111111111
1               111111111111111
1               111111111111111
1         111   1       11111111
1       111    11111   1
1      11   111 1      11111
1   111   111   1 111111
1  11111111111  111
1       111    11
111    111     111111111111
1 1                      11
111                     11
  11111111111    11111111111111
 11111111111    11111111111111
 1            11             1
 1            11        1  1 1
 1 111111111    1        1   1
11 1111111111   1        1   1
1           11 1        1111 1
1           11  1            1  1
1           11        1111 1 1
1   11 11    11        1 1 1 1
1   11111    11              11
1   1 1    11       N      1 1
1   11111    11              11
1   11 11    11 111 11111111111
1           11  11  1
1   1 1 1  11  1111111111111111
1  11111111  111111 1
1111    11111111 111111111111111

