FLOOR ./textures/wood.xpm
CEILING ./textures/colorstone.xpm
WALL ./textures/redbrick.xpm
DOOR ./textures/door.xpm
BARREL ./textures/barrel.xpm
PILLAR ./textures/pillar.xpm
LIGHT ./textures/greenlight.xpm
TREE1 ./textures/eagle.xpm
TREE2 ./textures/bluestone.xpm
TREE3 ./textures/purplestone.xpm
TREE4 ./textures/greystone.xpm
TREE5 ./textures/mossy.xpm

SP 6.5 23.5 BARREL
SP 9.5 23.5 PILLAR
SP 6.5 25.5 LIGHT
SP 9.5 25.5 TREE
SP 2.5 24.5 LIGHT
SP 2.5 19.5 LIGHT
SP 2.5 14.5 LIGHT
SP 5.5 15.5 BARREL
SP 6.5 14.5 BARREL
SP 7.5 13.5 BARREL
SP 8.5 12.5 BARREL
SP 21.5 14.5 TREE
SP 28.5 15.5 PILLAR
SP 14.5 15.5 PILLAR
SP 1.5 20.5 TREE



111111111111111111111111111111
100000000000000000010010000001
100000000000000001000000100001
100000000000000000111111000001
100000000000000000000000000001
100000001111111100000000000001
100000011000010001000011110001
100000110000010001000000100001
100001100000010001010001000001
100011000000010001111011110001
100010000000010000010000000001
100110000000010000000000000001
100100000000010000000000000001
122110000000020000000000000001
100010000000011111111211111111
100010000000010000000000000001
100010000000010000000000000001
100010000000010000000000000001
100020000000010000000000000001
100010000000010000000100000001
100011111111110000001000000001
100020000000000000010000000001
100010000000010000100000000001
100010000000010000000000000001
100010000000010000000000000001
100010000000010000000011110001
121110000000010000000102201001
101010000000010000000102201001
1N1020000000020000000100001001
111111111111111111111111111111