NO ./textures/north.xpm
SO ./textures/south.xpm
WE ./textures/west.xpm
EA ./textures/east.xpm

F 100,100,100
C 135,206,235

         111111
         1   01
         101001
         1100N1
         111111